0,2,31,0,4,4,39
0,2,49,0,3,3,55
0,2,46,0,3,6,55
0,2,51,0,2,5,58
1,2,57,6,15,16,94
0,2,44,0,5,4,53
0,2,37,0,1,4,42
0,2,42,4,4,5,55
0,2,51,0,9,7,67
0,2,34,0,4,7,45
0,2,45,0,1,1,47
0,2,45,0,1,3,49
0,2,50,0,3,0,53
0,2,34,0,4,4,42
3,2,129,22,42,1,194
3,2,144,16,49,0,209
1,2,111,28,20,3,162
1,2,67,11,10,16,104
1,2,65,24,7,16,112
1,2,94,27,7,16,144
1,2,94,20,8,7,129
0,2,67,29,5,10,111
1,2,56,12,2,14,84
0,2,57,13,3,11,84
3,2,129,22,42,1,194
3,2,144,16,49,0,209
1,2,111,28,20,3,162
3,2,120,27,46,3,196
3,2,102,39,47,1,189
3,2,145,23,27,0,195
3,2,114,37,21,5,177
1,2,108,18,22,1,149
3,2,122,28,33,1,184
3,2,114,39,30,3,186
3,2,150,36,25,1,212
3,2,107,10,49,2,168
3,2,124,24,22,0,170
2,2,77,16,39,29,161
1,2,15,23,30,21,89
2,2,32,22,38,21,113
2,2,68,13,29,24,134
1,2,27,16,36,30,109
1,2,76,7,11,15,109
1,2,41,23,20,17,101
1,2,33,10,3,29,75
1,2,58,8,14,29,109
1,2,65,7,11,26,109
1,2,47,9,6,29,91
1,2,38,10,5,25,78
1,2,57,8,12,29,106
1,2,20,6,4,20,50
1,2,24,9,14,23,70
1,2,52,10,13,21,96
2,2,79,15,36,18,148
1,2,84,24,22,18,148
2,2,59,19,35,16,129
2,2,88,26,31,19,164
1,2,24,11,32,13,80
3,2,110,17,23,20,170
0,2,29,26,5,6,66
1,2,43,26,11,20,100
1,2,68,28,9,15,120
1,2,108,16,8,18,150
1,2,101,26,8,14,149
3,2,141,31,36,6,214
3,2,120,25,28,5,178
3,2,137,23,44,5,209
3,2,124,11,30,7,172
3,2,145,25,49,7,226
3,2,122,37,23,8,190
3,2,136,30,20,9,195
3,2,145,18,40,9,212
3,2,138,34,28,5,205
3,2,123,10,29,8,170
1,2,105,15,21,9,150
1,2,75,22,20,11,128
1,2,90,12,10,13,125
1,2,102,22,20,16,160
2,2,61,18,15,27,121
0,2,70,8,14,6,98
2,2,80,17,12,34,143
1,2,62,12,14,19,107
1,2,96,5,11,13,125
1,2,102,6,12,13,133
1,2,91,14,15,6,126
1,2,95,8,17,13,133
2,2,75,15,12,21,123
1,2,53,21,20,10,104
1,2,13,1,0,19,33
1,2,10,0,1,24,35
1,2,16,2,0,33,51
1,2,11,1,0,29,41
1,2,18,2,1,13,34
0,2,15,0,1,11,27
1,2,14,1,0,33,48
1,2,17,2,0,22,41
1,3,12,2,1,17,32
1,3,18,0,0,29,47
1,3,16,1,0,14,31
1,3,20,0,0,14,34
1,3,20,1,1,30,52
1,3,15,0,1,23,39
1,3,16,0,1,26,43
0,3,18,4,0,11,33
1,3,17,3,1,36,57
0,3,14,4,1,10,29
1,3,18,2,1,25,46
1,3,12,2,0,19,33
1,3,11,4,0,30,45
1,3,19,1,1,36,57
1,3,10,4,0,36,50
1,3,20,1,1,32,54
1,3,15,5,1,40,61
1,3,104,6,5,1,116
1,3,109,25,3,8,145
1,3,82,23,8,20,133
1,3,81,25,1,18,125
1,3,95,16,10,1,122
1,3,91,24,7,6,128
1,3,81,30,10,0,121
2,3,125,13,26,2,166
3,3,125,39,49,3,216
3,3,125,34,37,1,197
3,3,125,19,25,4,173
3,3,125,15,49,0,189
3,3,125,32,50,5,212
3,3,125,38,50,1,214
3,3,125,29,29,3,186
3,3,125,31,48,4,208
3,3,125,32,50,0,207
3,3,125,31,45,0,201
1,3,125,21,20,1,167
3,3,125,28,36,0,189
1,3,39,10,37,16,102
1,3,89,8,12,13,122
1,3,51,16,16,13,96
1,3,17,9,18,28,72
2,3,48,25,36,21,130
2,3,93,7,30,16,146
2,3,55,15,36,15,121
1,3,51,10,8,22,91
1,3,51,7,3,24,85
1,3,51,9,7,30,97
1,3,51,7,14,20,92
1,3,51,10,14,20,95
1,3,51,10,6,22,89
1,3,51,8,11,22,92
1,3,51,6,10,26,93
1,3,51,7,7,27,92
1,3,104,17,25,20,166
1,3,6,28,27,14,75
2,3,54,29,37,9,129
1,3,43,13,30,20,106
2,3,60,21,26,11,118
1,3,101,23,8,20,152
1,3,62,26,19,11,118
0,3,39,24,13,11,87
2,3,90,20,35,7,152
3,3,109,30,22,20,181
1,3,68,26,25,20,139
3,3,142,22,37,6,207
1,3,113,14,20,5,152
3,3,142,13,37,8,200
2,3,108,23,26,9,166
3,3,122,29,30,7,188
3,3,133,12,30,7,182
3,3,118,23,38,10,189
3,3,121,35,26,8,190
1,3,116,23,20,8,167
3,3,132,12,27,8,179
3,3,144,17,33,7,201
1,3,103,21,11,11,146
1,3,107,15,10,15,147
1,3,50,10,10,17,87
1,3,108,15,10,6,139
3,3,108,24,15,29,176
1,3,101,6,15,13,135
1,3,55,17,12,19,103
1,3,77,7,20,16,120
1,3,91,12,19,8,130
2,3,95,25,17,29,166
2,3,78,17,17,27,139
2,3,98,16,16,21,151
2,3,86,13,11,35,145
1,3,18,4,0,16,38
0,3,18,5,0,12,35
1,3,18,2,1,25,46
1,3,18,1,0,17,36
1,3,18,5,0,21,44
0,3,18,0,1,12,31
1,3,18,3,1,28,50
1,3,18,4,1,40,63
1,4,18,1,1,39,59
1,4,18,4,0,30,52
1,4,18,5,1,13,37
1,4,18,2,0,37,57
1,4,18,0,0,13,31
0,4,18,5,0,11,34
0,4,18,5,1,12,36
1,4,18,1,1,16,36
1,4,18,1,1,34,54
1,4,18,1,0,24,43
1,4,18,0,0,23,41
1,4,18,0,0,27,45
1,4,18,5,0,28,51
1,4,18,1,0,14,33
1,4,18,5,0,25,48
1,4,18,4,1,30,53
1,4,18,5,1,30,54
0,4,62,24,7,2,95
0,4,51,23,6,1,81
1,4,114,23,10,19,166
1,4,85,22,9,9,125
1,4,102,24,4,20,150
1,4,101,18,3,17,139
1,4,116,19,0,17,152
3,4,117,38,50,5,210
3,4,114,32,34,2,182
1,4,120,17,23,1,161
3,4,145,20,25,2,192
3,4,125,30,48,1,204
3,4,103,27,45,1,176
3,4,114,20,43,1,178
3,4,145,10,44,1,200
3,4,147,31,20,4,202
3,4,104,24,40,0,168
1,4,124,11,22,0,157
3,4,101,37,31,4,173
3,4,144,30,37,1,212
1,4,24,18,37,18,97
1,4,24,8,17,25,74
1,4,16,22,12,20,70
1,4,26,2,39,26,93
1,4,90,7,18,15,130
0,4,59,6,11,11,87
1,4,28,7,22,18,75
1,4,60,5,14,21,100
1,4,69,9,8,23,109
1,4,59,9,12,26,106
1,4,24,10,5,21,60
1,4,41,7,7,21,76
1,4,48,10,9,29,96
1,4,59,10,14,23,106
2,4,67,7,12,28,114
1,4,52,9,8,20,89
1,4,45,26,29,10,110
1,4,14,21,7,18,60
1,4,55,22,24,10,111
1,4,45,14,39,5,103
1,4,90,17,16,11,134
1,4,33,21,25,5,84
3,4,118,25,31,13,187
1,4,86,28,13,5,132
3,4,105,29,22,12,168
1,4,10,19,26,8,63
1,4,46,22,18,9,95
3,4,105,35,48,6,194
3,4,135,37,34,5,211
3,4,103,29,44,6,182
3,4,113,13,42,10,178
2,4,103,20,27,9,159
3,4,150,13,20,9,192
3,4,116,25,33,8,182
3,4,109,16,41,9,175
3,4,112,11,50,5,178
3,4,104,31,30,5,170
3,4,146,18,40,6,210
3,4,110,24,10,29,173
2,4,60,15,12,25,112
2,4,103,9,14,29,155
1,4,102,6,15,6,129
1,4,51,17,16,8,92
1,4,62,12,11,18,103
1,4,103,14,12,5,134
1,4,50,7,11,23,91
1,4,80,14,20,6,120
2,4,98,13,18,21,150
1,4,53,25,20,13,111
1,4,52,8,10,27,97
2,4,71,23,13,21,128
1,4,17,3,0,29,49
1,4,20,5,1,36,62
1,4,15,0,0,32,47
1,4,15,0,1,20,36
1,4,14,2,0,23,39
1,4,13,1,0,29,43
1,4,14,5,0,31,50
1,4,16,3,0,33,52
1,5,18,4,1,15,38
1,5,20,0,1,23,44
1,5,19,3,0,16,38
0,5,10,3,0,12,25
1,5,10,4,0,23,37
1,5,12,5,0,29,46
1,5,10,0,0,39,49
1,5,16,2,1,21,40
1,5,18,4,1,36,59
1,5,15,1,0,14,30
1,5,17,4,0,13,34
1,5,18,3,1,24,46
0,5,19,2,0,11,32
1,5,19,3,0,21,43
1,5,19,3,1,31,54
1,5,14,2,1,19,36
1,5,11,0,0,27,38
0,5,27,6,1,11,45
1,5,33,11,6,13,63
0,5,63,6,7,10,86
1,5,58,13,4,15,90
0,5,57,11,7,10,85
0,5,63,10,6,12,91
1,5,74,9,0,15,98
0,5,71,9,7,10,97
1,5,33,9,6,13,61
0,5,29,6,1,12,48
0,5,32,9,3,11,55
0,5,57,14,3,11,85
1,5,31,11,0,14,56
0,5,30,9,3,10,52
0,5,61,8,7,12,88
0,5,47,10,4,10,71
1,5,80,16,4,15,115
0,5,49,10,2,10,71
1,5,58,7,5,13,83
0,5,53,19,1,10,83
3,5,132,47,25,0,204
3,5,131,52,15,0,198
3,5,171,59,27,3,260
3,5,131,43,20,3,197
3,5,177,56,12,4,249
3,5,160,47,30,3,240
3,5,178,68,28,4,278
3,5,169,70,20,3,262
3,5,133,56,25,2,216
3,5,151,52,13,0,216
3,5,179,46,27,3,255
3,5,144,68,20,0,232
3,5,162,46,19,2,229
3,5,159,44,23,2,228
3,5,174,67,30,1,272
3,5,136,57,29,4,226
3,5,156,42,12,3,213
3,5,175,63,19,3,260
3,5,172,62,20,2,256
3,5,171,49,15,0,235
3,5,172,65,18,2,257
3,5,176,50,13,1,240
3,5,153,50,23,3,229
3,5,148,64,27,0,239
0,5,56,28,6,2,92
1,5,88,26,25,0,139
1,5,82,23,14,0,119
0,5,77,20,7,0,104
0,5,66,24,1,0,91
0,5,72,22,8,2,104
1,5,62,28,21,2,113
0,5,66,26,4,1,97
0,5,85,20,4,0,109
1,5,87,24,11,2,124
1,5,67,28,25,0,120
1,5,70,26,16,2,114
1,5,62,20,20,1,103
0,5,67,29,1,0,97
0,5,65,25,1,1,92
1,5,76,24,23,0,123
0,5,42,1,5,11,59
0,5,42,10,3,1,56
0,5,31,11,1,12,55
0,5,47,7,3,6,63
0,5,28,7,2,4,41
0,5,22,3,6,1,32
0,5,29,1,7,5,42
0,5,43,9,1,11,64
0,5,23,3,3,8,37
1,5,21,2,5,15,43
0,5,31,2,1,9,43
1,5,15,5,0,18,38
1,5,11,2,0,15,28
1,5,12,0,1,17,30
1,5,18,3,0,18,39
1,5,19,1,0,31,51
1,5,17,0,0,22,39
1,5,15,5,0,14,34
1,5,15,1,1,24,41
1,6,18,4,0,33,55
1,6,14,4,0,34,52
1,6,14,0,1,19,34
1,6,19,3,0,36,58
1,6,10,4,1,21,36
1,6,19,1,0,19,39
1,6,18,5,0,26,49
1,6,17,1,1,25,44
0,6,20,2,0,12,34
1,6,15,5,0,15,35
1,6,11,4,0,14,29
1,6,14,3,1,18,36
1,6,13,2,0,39,54
1,6,17,5,0,29,51
1,6,13,5,0,31,49
1,6,18,5,0,35,58
1,6,15,4,0,16,35
0,6,55,15,5,3,78
0,6,76,10,7,9,102
1,6,98,0,9,19,126
1,6,98,12,6,6,122
1,6,103,2,10,20,135
1,6,93,17,8,12,130
1,6,115,27,9,16,167
1,6,120,12,22,3,157
3,6,142,18,27,0,187
3,6,117,29,49,2,197
3,6,126,36,24,0,186
3,6,110,39,38,5,192
3,6,149,20,39,5,213
1,6,109,29,23,5,166
3,6,124,34,24,4,186
3,6,149,35,32,1,217
3,6,125,32,38,4,199
2,6,101,23,38,1,163
3,6,137,36,30,0,203
3,6,139,15,21,3,178
1,6,19,3,29,9,60
1,6,13,11,39,7,70
1,6,31,2,29,27,89
1,6,18,24,21,22,85
1,6,26,12,14,13,65
1,6,31,15,13,28,87
0,6,12,22,8,11,53
1,6,54,5,13,23,95
1,6,59,7,13,21,100
1,6,58,8,6,23,95
1,6,53,8,9,25,95
1,6,54,7,7,20,88
1,6,39,10,4,29,82
1,6,38,9,8,22,77
1,6,36,5,10,23,74
1,6,68,6,12,24,110
1,6,50,18,26,14,108
3,6,120,28,22,20,190
1,6,60,14,28,9,111
1,6,105,14,8,19,146
1,6,89,27,18,8,142
1,6,28,17,31,10,86
1,6,79,14,23,6,122
1,6,15,11,30,14,70
1,6,77,27,23,18,145
1,6,19,14,24,6,63
2,6,79,13,28,7,127
1,6,114,10,22,9,155
3,6,150,30,22,5,207
3,6,142,23,25,7,197
3,6,111,36,25,6,178
3,6,143,37,38,8,226
3,6,120,37,43,10,210
1,6,147,20,49,7,223
3,6,140,22,27,5,194
3,6,128,37,20,9,194
3,6,114,23,42,10,189
3,6,117,20,22,9,168
2,6,93,24,17,23,157
0,6,65,15,15,8,103
1,6,100,22,14,8,144
1,6,85,12,11,18,126
0,6,56,7,12,12,87
1,6,50,12,15,18,95
0,6,74,9,11,12,106
1,6,73,15,18,7,113
2,6,99,13,20,30,162
1,6,110,14,17,8,149
2,6,82,5,12,34,133
1,6,58,19,12,17,106
2,6,70,10,14,32,126
1,6,10,1,0,33,44
1,6,14,1,1,40,56
1,6,17,1,1,17,36
1,6,12,4,1,22,39
1,6,15,0,0,16,31
1,6,13,4,0,25,42
0,6,14,5,1,12,32
1,6,18,1,1,35,55
1,7,18,5,1,19,43
1,7,19,3,0,38,60
0,7,13,0,1,12,26
1,7,20,0,1,38,59
1,7,20,1,1,24,46
1,7,17,3,1,17,38
1,7,12,3,1,35,51
1,7,19,0,1,30,50
1,7,19,2,1,30,52
1,7,18,1,0,16,35
1,7,11,0,0,31,42
0,7,10,1,1,12,24
1,7,16,1,0,24,41
1,7,18,3,0,28,49
1,7,20,1,1,39,61
1,7,19,3,1,27,50
1,7,14,1,1,34,50
1,7,61,26,1,16,104
0,7,72,26,6,4,108
1,7,86,24,3,18,131
0,7,75,1,8,10,94
0,7,75,1,7,9,92
0,7,93,5,4,1,103
1,7,111,6,2,5,124
3,7,111,18,41,2,172
3,7,114,27,46,0,187
3,7,139,19,50,2,210
2,7,109,14,38,1,162
1,7,105,16,22,3,146
3,7,150,13,31,4,198
3,7,122,13,47,3,185
3,7,114,24,46,2,186
3,7,119,36,41,0,196
3,7,108,35,39,0,182
2,7,113,18,28,1,160
3,7,118,36,37,0,191
3,7,113,35,48,3,199
2,7,66,7,22,30,125
1,7,64,12,27,8,111
0,7,37,5,13,11,66
2,7,82,17,31,20,150
1,7,63,5,23,12,103
1,7,20,12,16,24,72
1,7,46,5,34,9,94
1,7,35,9,8,29,81
1,7,33,9,11,21,74
1,7,32,9,10,30,81
1,7,62,10,6,22,100
1,7,62,10,11,22,105
1,7,54,10,12,25,101
1,7,48,8,15,23,94
1,7,20,10,12,24,66
1,7,35,10,5,30,80
3,7,112,15,40,10,177
1,7,51,21,25,13,110
1,7,53,12,23,8,96
1,7,63,22,18,15,118
1,7,50,23,16,8,97
2,7,94,20,35,17,166
1,7,7,27,39,17,90
1,7,109,18,13,6,146
1,7,18,27,19,6,70
0,7,21,30,5,5,61
0,7,49,16,9,12,86
3,7,129,28,40,6,203
3,7,141,18,28,8,195
3,7,131,14,43,7,195
3,7,105,38,23,5,171
3,7,125,35,37,5,202
3,7,127,36,42,9,214
3,7,129,22,25,9,185
3,7,121,39,47,8,215
3,7,138,29,42,9,218
3,7,119,26,21,5,171
3,7,138,17,48,8,211
2,7,72,12,14,32,130
2,7,92,23,20,30,165
2,7,94,17,11,24,146
2,7,102,25,12,24,163
1,7,71,23,17,14,125
1,7,58,5,19,25,107
1,7,93,22,18,10,143
2,7,59,23,10,35,127
1,7,57,20,10,20,107
2,7,96,9,18,25,148
1,7,104,12,16,20,152
2,7,104,22,17,23,166
2,7,88,8,11,29,136
1,7,20,3,0,16,39
1,7,17,2,1,30,50
1,7,17,4,0,23,44
1,7,15,5,0,21,41
1,7,10,0,1,31,42
1,7,11,1,1,19,32
1,7,12,2,0,29,43
0,7,11,0,1,11,23
1,1,18,4,1,28,51
1,1,13,3,0,26,42
1,1,16,3,0,34,53
1,1,16,4,0,35,55
1,1,20,2,1,33,56
1,1,14,4,1,28,47
1,1,11,4,1,19,35
1,1,19,4,0,17,40
1,1,18,3,1,26,48
1,1,10,1,1,21,33
1,1,20,5,1,40,66
1,1,11,5,0,37,53
1,1,15,4,1,29,49
1,1,16,2,1,27,46
1,1,10,3,1,23,37
1,1,16,5,1,31,53
1,1,20,0,1,30,51
1,1,61,4,5,17,87
0,1,91,8,6,2,107
0,1,94,4,5,2,105
1,1,117,8,6,16,147
1,1,111,14,10,14,149
0,1,91,2,3,5,101
1,1,96,9,1,16,122
3,1,134,15,42,5,196
3,1,121,35,39,4,199
3,1,118,40,40,3,201
3,1,115,17,40,1,173
2,1,106,22,37,0,165
3,1,147,26,40,0,213
2,1,102,13,31,2,148
1,1,102,12,24,3,141
3,1,130,40,31,2,203
2,1,102,17,33,0,152
3,1,105,13,48,5,171
3,1,129,24,25,0,178
3,1,117,11,45,0,173
2,1,74,14,23,21,132
2,1,80,14,35,18,147
1,1,31,7,34,24,96
1,1,18,15,9,15,57
1,1,15,10,23,20,68
1,1,37,18,8,16,79
1,1,10,7,5,14,36
1,1,54,6,15,23,98
1,1,34,7,5,24,70
1,1,50,7,8,21,86
1,1,44,9,10,24,87
1,1,63,8,15,24,110
1,1,56,6,6,29,97
2,1,69,5,13,27,114
1,1,39,5,3,30,77
1,1,61,10,14,24,109
1,1,61,30,5,20,116
0,1,20,17,9,5,51
2,1,70,22,38,7,137
1,1,25,30,31,9,95
0,1,23,13,12,6,54
1,1,105,30,24,8,167
1,1,107,10,6,6,129
1,1,40,20,36,7,103
2,1,74,18,37,11,140
0,1,62,15,8,11,96
1,1,81,20,14,12,127
3,1,111,32,43,5,191
3,1,145,12,41,6,204
3,1,139,11,20,7,177
3,1,129,40,31,10,210
3,1,128,22,28,8,186
1,1,103,17,23,8,151
3,1,127,32,29,7,195
3,1,120,35,44,8,207
2,1,106,11,41,7,165
3,1,114,40,31,5,190
1,1,101,13,20,7,141
3,1,110,25,19,34,188
2,1,108,6,17,23,154
1,1,104,12,10,10,136
2,1,102,22,17,23,164
1,1,77,19,16,8,120
2,1,70,16,19,33,138
2,1,75,9,13,28,125
2,1,95,9,16,29,149
2,1,77,17,17,22,133
2,1,73,16,14,34,137
1,1,59,7,18,12,96
0,1,54,20,10,9,93
2,1,90,6,18,32,146
1,1,15,5,1,32,53
0,1,12,1,0,11,24
1,1,17,2,0,28,47
0,1,13,5,1,12,31
1,1,15,5,0,21,41
0,1,18,4,0,11,33
1,1,12,4,0,21,37
0,1,10,4,1,12,27
1,2,15,2,0,25,42
1,2,11,0,0,24,35
1,2,15,2,1,15,33
1,2,20,3,1,29,53
1,2,17,2,0,24,43
1,2,19,5,1,26,51
1,2,20,3,1,32,56
1,2,15,3,0,19,37
1,2,13,5,0,17,35
1,2,12,5,1,19,37
1,2,10,2,0,27,39
1,2,20,4,1,23,48
1,2,14,0,0,16,30
1,2,12,4,1,28,45
1,2,19,2,0,20,41
1,2,20,2,1,19,42
1,2,16,0,0,36,52
1,2,62,20,4,18,104
1,2,50,13,2,14,79
1,2,101,3,6,6,116
1,2,94,15,2,9,120
0,2,68,10,8,1,87
1,2,95,3,8,20,126
1,2,113,7,10,16,146
2,2,106,13,39,1,159
3,2,105,32,47,4,188
3,2,150,19,34,4,207
3,2,137,38,39,2,216
2,2,113,11,32,1,157
3,2,117,30,26,5,178
3,2,130,10,37,1,178
3,2,150,32,31,1,214
3,2,146,10,30,3,189
3,2,123,24,46,2,195
2,2,110,24,26,4,164
3,2,111,33,31,2,177
3,2,132,18,32,2,184
1,2,66,16,22,13,117
1,2,45,24,5,23,97
1,2,92,19,15,7,133
2,2,78,22,16,25,141
1,2,90,2,15,18,125
1,2,23,2,37,9,71
1,2,17,5,6,20,48
1,2,41,5,4,24,74
1,2,32,5,15,26,78
1,2,65,7,7,22,101
1,2,22,6,3,25,56
1,2,54,7,4,28,93
1,2,38,5,8,28,79
1,2,59,7,15,23,104
1,2,34,8,10,23,75
1,2,28,6,3,27,64
1,2,7,16,11,14,48
1,2,8,12,22,8,50
2,2,42,25,38,18,123
2,2,82,13,28,5,128
1,2,14,24,26,9,73
1,2,39,25,33,9,106
1,2,47,14,29,6,96
3,2,120,20,21,18,179
3,2,114,11,39,10,174
2,2,99,24,30,10,163
2,2,78,18,30,8,134
1,2,144,40,29,10,223
3,2,107,28,38,9,182
3,2,123,28,24,10,185
3,2,126,15,28,6,175
3,2,147,28,23,5,203
2,2,100,21,33,7,161
1,2,113,12,22,6,153
3,2,130,34,30,6,200
3,2,118,40,29,10,197
3,2,113,38,44,9,204
3,2,117,29,29,9,184
3,2,106,12,20,32,170
1,2,96,11,15,14,136
1,2,58,11,14,24,107
1,2,76,22,10,9,117
2,2,66,6,12,33,117
1,2,61,23,13,18,115
1,2,93,6,15,17,131
1,2,51,11,16,26,104
1,2,86,6,12,9,113
2,2,77,15,12,29,133
1,2,84,15,16,8,123
1,2,103,12,15,10,140
1,2,60,9,11,27,107
1,2,14,1,1,22,38
1,2,14,2,0,35,51
1,2,13,1,1,31,46
1,2,19,0,1,22,42
1,2,13,4,0,28,45
1,2,13,1,0,26,40
1,2,12,0,1,34,47
1,2,20,1,1,38,60
1,3,12,3,0,38,53
1,3,12,1,0,40,53
0,3,20,5,0,10,35
1,3,12,4,1,27,44
1,3,15,5,0,21,41
1,3,19,2,0,30,51
1,3,11,0,1,40,52
1,3,15,3,0,35,53
1,3,15,0,1,37,53
1,3,16,2,0,37,55
1,3,10,0,1,24,35
1,3,12,0,1,31,44
1,3,15,1,1,36,53
1,3,14,5,0,17,36
1,3,17,3,1,38,59
1,3,19,0,0,18,37
1,3,18,5,1,30,54
1,3,119,12,6,4,141
1,3,74,28,1,13,116
1,3,101,26,10,0,137
1,3,99,4,7,19,129
1,3,99,18,7,5,129
1,3,102,24,2,8,136
1,3,50,4,6,13,73
3,3,128,11,46,4,189
3,3,129,39,43,0,211
3,3,129,27,38,0,194
1,3,113,24,22,2,161
3,3,141,15,21,5,182
3,3,120,22,29,1,172
3,3,141,24,47,4,216
3,3,149,24,33,1,207
3,3,140,40,36,1,217
3,3,140,20,36,0,196
2,3,107,13,31,4,155
3,3,141,15,32,4,192
3,3,120,27,38,4,189
1,3,70,14,21,5,110
2,3,55,24,16,21,116
1,3,52,18,22,16,108
1,3,65,4,19,21,109
2,3,54,10,30,28,122
1,3,37,3,32,18,90
1,3,23,3,37,18,81
1,3,43,7,7,29,86
1,3,22,6,13,24,65
1,3,21,10,6,30,67
1,3,48,8,11,22,89
1,3,35,5,12,20,72
1,3,69,5,13,22,109
1,3,22,9,10,21,62
1,3,46,5,9,23,83
1,3,49,5,11,21,86
1,3,29,18,29,20,96
2,3,96,23,31,14,164
1,3,100,27,23,16,166
2,3,96,22,36,5,159
1,3,27,26,25,15,93
3,3,114,21,32,5,172
2,3,74,27,34,10,145
1,3,14,16,9,14,53
2,3,84,30,26,10,150
1,3,96,19,14,18,147
1,3,40,15,28,5,88
3,3,110,15,46,5,176
3,3,138,39,31,7,215
3,3,118,32,32,10,192
1,3,142,34,38,9,223
1,3,113,13,36,5,167
3,3,104,29,32,7,172
3,3,134,39,21,9,203
3,3,107,15,48,5,175
3,3,139,25,43,7,214
3,3,128,20,20,6,174
3,3,101,13,47,10,171
2,3,105,17,13,23,158
1,3,103,14,13,9,139
1,3,51,23,15,13,102
1,3,84,10,16,20,130
2,3,97,25,19,24,165
1,3,98,8,10,19,135
2,3,94,13,19,25,151
3,3,105,25,11,35,176
0,3,74,9,13,6,102
2,3,57,18,13,28,116
2,3,57,14,11,33,115
1,3,84,23,19,15,141
3,3,105,14,16,33,168
1,3,10,4,1,38,53
1,3,15,1,1,29,46
1,3,14,1,1,25,41
1,3,20,2,0,37,59
1,3,20,1,0,27,48
1,3,13,1,1,18,33
1,3,19,0,0,35,54
1,3,14,1,1,27,43
0,4,13,5,0,12,30
0,4,18,5,0,12,35
1,4,10,3,1,32,46
1,4,14,2,0,15,31
1,4,16,3,0,15,34
1,4,14,2,0,25,41
1,4,17,5,0,18,40
1,4,13,1,0,28,42
1,4,19,0,1,20,40
1,4,15,4,0,40,59
1,4,14,3,1,26,44
1,4,15,4,0,14,33
1,4,12,3,1,13,29
1,4,12,4,0,31,47
1,4,17,4,1,20,42
1,4,12,0,1,13,26
1,4,18,2,0,16,36
1,4,115,16,10,13,154
1,4,117,5,10,15,147
1,4,92,26,8,7,133
0,4,88,3,6,4,101
1,4,109,11,4,3,127
1,4,81,4,0,20,105
1,4,118,2,5,19,144
2,4,107,26,31,2,166
2,4,103,11,35,5,154
3,4,145,13,33,3,194
3,4,143,22,37,4,206
3,4,113,38,50,3,204
3,4,149,10,47,3,209
3,4,132,33,35,2,202
3,4,119,40,41,2,202
3,4,133,31,27,2,193
3,4,140,20,44,4,208
3,4,140,34,31,1,206
3,4,128,37,50,2,217
3,4,132,11,24,3,170
1,4,23,8,40,27,98
2,4,75,2,18,29,124
2,4,99,14,33,14,160
0,4,10,1,13,7,31
2,4,74,21,29,26,150
1,4,29,15,25,5,74
2,4,50,17,38,24,129
1,4,64,9,14,20,107
1,4,49,5,10,21,85
1,4,39,7,10,30,86
1,4,68,5,5,24,102
1,4,67,7,8,22,104
1,4,47,8,3,25,83
1,4,66,9,7,24,106
1,4,46,8,3,22,79
1,4,54,6,12,21,93
1,4,18,16,32,18,84
0,4,24,20,7,9,60
1,4,113,17,16,20,166
0,4,52,13,15,10,90
1,4,58,26,25,18,127
1,4,44,19,22,6,91
1,4,8,26,34,9,77
1,4,31,10,27,8,76
1,4,115,24,16,5,160
1,4,56,29,16,16,117
1,4,7,12,33,12,64
3,4,133,10,46,10,199
3,4,104,31,37,6,178
3,4,100,38,36,9,183
3,4,127,25,37,5,194
3,4,118,32,48,6,204
3,4,147,19,31,8,205
3,4,123,36,34,5,198
1,4,111,24,25,5,165
3,4,121,16,42,8,187
3,4,119,38,47,7,211
3,4,132,30,41,6,209
1,4,52,6,12,18,88
1,4,97,21,10,8,136
2,4,50,16,20,31,117
1,4,94,25,19,8,146
2,4,66,11,18,34,129
1,4,105,16,15,6,142
1,4,56,23,10,18,107
2,4,105,19,10,25,159
1,4,60,18,11,16,105
1,4,88,10,14,11,123
2,4,110,6,14,23,153
2,4,78,20,11,35,144
1,4,105,14,10,7,136
0,4,18,1,0,10,29
1,4,18,1,0,27,46
1,4,12,4,1,18,35
1,4,15,4,1,32,52
1,4,13,4,0,32,49
1,4,14,4,0,15,33
1,4,15,4,0,17,36
1,4,14,0,1,21,36
1,5,17,5,0,37,59
0,5,14,4,1,12,31
1,5,16,2,0,15,33
1,5,13,4,1,14,32
1,5,12,4,0,29,45
1,5,19,4,1,30,54
1,5,18,4,0,18,40
0,5,18,1,1,12,32
1,5,20,4,1,21,46
1,5,10,2,1,20,33
1,5,18,5,1,23,47
1,5,16,5,1,30,52
1,5,12,3,0,40,55
1,5,12,2,0,40,54
1,5,16,0,1,37,54
1,5,15,4,1,16,36
1,5,13,0,0,38,51
1,5,61,5,3,14,83
0,5,27,15,6,10,58
1,5,74,11,5,15,105
1,5,70,6,7,14,97
0,5,33,6,0,11,50
1,5,29,12,1,13,55
0,5,69,5,7,10,91
1,5,41,16,7,15,79
0,5,35,11,5,11,62
1,5,25,9,6,14,54
0,5,65,15,1,11,92
1,5,66,6,3,14,89
1,5,27,6,5,15,53
0,5,75,6,1,10,92
0,5,54,11,4,12,81
0,5,54,18,3,12,87
1,5,69,8,0,14,91
0,5,52,19,6,10,87
0,5,66,8,0,12,86
1,5,54,11,0,13,78
3,5,151,48,15,3,217
3,5,170,62,18,2,252
3,5,134,59,11,3,207
3,5,166,63,22,1,252
3,5,173,64,10,2,249
3,5,176,45,22,2,245
3,5,162,59,27,1,249
3,5,171,46,15,3,235
3,5,158,44,26,2,230
3,5,151,64,16,0,231
3,5,162,65,14,3,244
3,5,179,44,23,1,247
3,5,175,59,11,3,248
3,5,173,63,13,2,251
3,5,144,66,11,3,224
3,5,132,68,22,4,226
3,5,161,50,10,0,221
3,5,151,56,29,1,237
3,5,168,59,24,1,252
3,5,144,65,20,3,232
3,5,179,63,12,2,256
3,5,161,56,12,4,233
3,5,134,67,12,1,214
3,5,140,70,23,4,237
1,5,66,29,24,1,120
1,5,60,27,17,2,106
1,5,89,27,10,2,128
1,5,81,29,5,0,115
1,5,78,22,12,1,113
1,5,71,24,18,2,115
0,5,50,26,9,1,86
0,5,55,28,5,0,88
1,5,61,20,25,1,107
1,5,76,22,14,2,114
1,5,50,20,23,1,94
1,5,89,26,0,2,117
1,5,62,20,17,0,99
1,5,83,20,23,2,128
0,5,65,20,2,0,87
0,5,60,21,2,1,84
0,5,36,8,3,9,56
0,5,39,5,4,11,59
0,5,26,8,3,0,37
0,5,23,4,0,5,32
0,5,50,2,0,4,56
0,5,30,2,3,1,36
0,5,48,10,4,2,64
0,5,39,6,6,1,52
0,5,47,10,3,9,69
0,5,26,3,5,3,37
0,5,25,6,3,9,43
0,5,19,1,0,11,31
1,5,16,5,0,26,47
1,5,15,2,1,39,57
0,5,14,5,0,11,30
1,5,12,2,0,20,34
1,5,11,2,0,35,48
0,5,18,5,1,11,35
1,5,17,2,0,20,39
1,7,19,5,1,30,55
1,7,17,4,1,24,46
1,7,16,3,0,14,33
1,7,16,3,1,23,43
1,7,20,0,1,17,38
1,7,20,0,0,37,57
1,7,18,0,1,30,49
1,7,19,1,0,14,34
1,7,18,5,0,29,52
1,7,11,1,0,22,34
1,7,20,3,0,24,47
0,7,12,2,1,10,25
1,7,19,5,1,31,56
1,7,10,0,0,32,42
0,7,14,1,1,12,28
1,7,14,2,1,24,41
1,7,10,3,0,32,45
1,7,97,23,6,17,143
1,7,104,22,7,11,144
1,7,100,15,8,20,143
0,7,87,7,7,4,105
1,7,77,27,8,10,122
0,7,51,7,4,5,67
0,7,79,1,10,6,96
3,7,100,40,29,5,174
2,7,112,13,39,0,164
3,7,120,16,34,2,172
2,7,123,14,26,3,166
3,7,142,27,27,4,200
3,7,139,38,49,2,228
3,7,134,24,21,2,181
2,7,102,13,31,0,146
2,7,102,16,43,4,165
2,7,106,16,32,1,155
3,7,117,19,42,3,181
3,7,139,36,40,3,218
1,7,121,13,25,2,161
1,7,65,19,16,11,111
1,7,12,25,39,28,104
1,7,98,21,10,5,134
1,7,58,9,25,13,105
2,7,81,10,39,29,159
2,7,67,20,33,29,149
1,7,68,22,25,16,131
1,7,47,10,6,22,85
1,7,45,7,10,27,89
1,7,54,5,11,24,94
1,7,61,7,15,28,111
1,7,56,5,4,29,94
1,7,23,5,4,27,59
1,7,31,6,8,23,68
1,7,27,7,14,28,76
1,7,30,7,3,30,70
1,7,114,21,5,14,154
2,7,46,24,35,16,121
2,7,68,29,29,20,146
0,7,45,16,15,5,81
1,7,86,13,11,20,130
1,7,44,11,19,15,89
1,7,45,17,13,20,95
1,7,106,17,7,12,142
1,7,44,16,9,13,82
1,7,77,23,13,9,122
1,7,53,17,26,8,104
3,7,138,18,20,8,184
3,7,142,24,39,9,214
1,7,114,25,21,7,167
3,7,116,35,42,6,199
3,7,149,22,37,8,216
2,7,100,12,39,7,158
3,7,101,23,45,5,174
3,7,122,40,48,10,220
3,7,112,34,39,9,194
3,7,112,12,41,5,170
3,7,116,22,23,7,168
2,7,90,13,15,33,151
1,7,85,14,14,13,126
2,7,59,25,13,27,124
2,7,108,5,15,22,150
2,7,75,8,16,25,124
2,7,96,15,12,27,150
0,7,61,17,10,8,96
2,7,84,25,20,30,159
1,7,55,9,12,19,95
2,7,65,16,12,32,125
1,7,87,16,10,16,129
2,7,75,5,12,21,113
2,7,82,16,14,34,146
1,7,11,3,0,34,48
1,7,15,5,0,14,34
1,7,18,5,1,13,37
1,7,19,2,1,34,56
1,7,20,4,1,26,51
0,7,14,4,0,10,28
1,7,11,1,1,36,49
1,7,10,2,1,15,28
1,6,10,3,0,33,46
1,6,14,3,0,23,40
0,6,11,5,1,11,28
1,6,10,1,1,34,46
1,6,20,4,1,17,42
1,6,17,5,0,24,46
1,6,12,2,1,18,33
1,6,15,0,1,16,32
1,6,19,5,0,15,39
1,6,11,3,1,39,54
0,6,14,5,0,10,29
1,6,20,0,1,33,54
1,6,13,1,1,33,48
0,6,18,2,1,12,33
1,6,19,2,1,23,45
1,6,10,4,0,36,50
1,6,13,4,0,17,34
1,6,86,28,2,18,134
1,6,59,29,9,14,111
1,6,102,20,9,13,144
1,6,114,28,8,16,166
1,6,87,23,5,0,115
1,6,88,5,8,13,114
0,6,83,6,4,9,102
3,6,150,19,24,3,196
3,6,148,35,46,1,230
3,6,146,23,23,4,196
3,6,140,21,39,3,203
3,6,149,36,35,1,221
3,6,125,34,42,0,201
3,6,147,34,20,5,206
3,6,128,33,21,4,186
3,6,111,38,50,5,204
3,6,144,20,32,4,200
1,6,121,14,23,1,159
3,6,136,36,40,4,216
1,6,114,21,23,1,159
2,6,75,17,37,29,158
1,6,34,5,27,22,88
1,6,45,6,7,15,73
1,6,65,10,6,27,108
1,6,67,25,20,18,130
2,6,50,25,25,28,128
1,6,37,19,38,12,106
1,6,36,8,3,29,76
1,6,63,5,8,23,99
1,6,67,5,7,22,101
1,6,36,9,14,22,81
1,6,57,8,10,22,97
1,6,65,7,14,25,111
1,6,54,10,3,29,96
1,6,41,5,4,25,75
1,6,43,9,3,25,80
1,6,9,27,32,17,85
1,6,101,28,18,20,167
1,6,99,16,16,18,149
1,6,20,27,32,12,91
3,6,96,16,39,17,168
1,6,62,28,18,20,128
1,6,58,27,17,5,107
2,6,60,18,28,12,118
1,6,81,26,13,17,137
3,6,118,15,27,13,173
1,6,53,12,25,20,110
3,6,132,12,27,9,180
3,6,149,14,50,5,218
3,6,106,35,41,5,187
3,6,150,29,27,7,213
3,6,110,30,46,5,191
3,6,129,35,34,5,203
3,6,133,21,26,5,185
3,6,148,34,45,7,234
3,6,144,39,43,8,234
3,6,126,27,44,8,205
3,6,103,34,49,5,191
2,6,96,7,13,30,146
1,6,54,17,17,19,107
1,6,98,16,17,15,146
1,6,72,6,19,8,105
2,6,69,23,12,31,135
2,6,85,13,16,24,138
1,6,102,22,12,9,145
1,6,103,14,20,14,151
2,6,80,12,10,22,124
0,6,63,18,11,5,97
1,6,84,21,13,9,127
2,6,72,10,10,29,121
1,6,79,22,17,13,131
1,6,12,5,0,27,44
1,6,19,1,1,38,59
1,6,14,3,0,33,50
1,6,16,3,1,37,57
1,6,14,5,0,37,56
1,6,11,2,1,20,34
1,6,20,3,0,25,48
1,6,20,0,1,30,51
1,1,13,2,1,17,33
1,1,20,1,1,19,41
0,1,10,2,1,12,25
1,1,14,2,0,25,41
1,1,12,0,1,16,29
1,1,11,5,1,31,48
1,1,13,1,1,16,31
0,1,17,3,0,10,30
1,1,11,1,0,22,34
1,1,10,4,1,16,31
1,1,15,3,1,32,51
1,1,10,0,0,22,32
1,1,20,1,1,16,38
1,1,16,1,1,15,33
1,1,14,4,1,32,51
1,1,16,1,1,37,55
1,1,10,2,1,36,49
1,1,96,18,7,2,123
0,1,51,14,0,5,70
0,1,63,25,2,8,98
0,1,72,7,1,4,84
0,1,86,18,6,1,111
1,1,105,4,4,20,133
1,1,117,10,10,18,155
3,1,120,36,32,0,188
3,1,135,20,31,0,186
3,1,112,40,42,3,197
3,1,135,13,20,3,171
1,1,105,35,24,2,166
3,1,150,25,36,0,211
1,1,108,27,23,2,160
3,1,108,40,45,1,194
1,1,118,19,21,1,159
3,1,131,18,41,1,191
3,1,148,31,20,4,203
3,1,120,26,22,1,169
3,1,147,12,32,0,191
2,1,73,9,35,12,129
2,1,93,21,22,29,165
1,1,66,2,10,28,106
0,1,18,6,6,6,36
2,1,78,1,16,30,125
1,1,69,15,24,20,128
2,1,82,2,40,17,141
1,1,57,9,5,23,94
1,1,25,5,14,26,70
1,1,40,9,15,28,92
1,1,52,6,13,21,92
1,1,45,8,13,29,95
1,1,67,10,7,25,109
1,1,20,8,14,30,72
1,1,44,8,4,29,85
1,1,63,5,8,29,105
1,1,119,15,20,13,167
1,1,103,10,23,7,143
1,1,42,14,15,14,85
1,1,67,20,24,12,123
2,1,56,18,29,17,120
2,1,65,16,32,15,128
2,1,107,11,26,19,163
1,1,11,18,22,10,61
1,1,28,15,27,12,82
0,1,45,17,7,6,75
1,1,66,12,27,6,111
3,1,104,40,22,9,175
2,1,113,21,26,5,165
3,1,120,29,37,6,192
3,1,129,10,39,6,184
3,1,119,29,40,10,198
3,1,119,25,32,9,185
3,1,123,10,30,7,170
3,1,111,33,28,5,177
3,1,110,12,47,8,177
3,1,139,15,43,9,206
3,1,132,29,25,7,193
1,1,51,8,18,18,95
1,1,76,5,14,20,115
1,1,53,15,13,23,104
1,1,50,25,19,9,103
2,1,86,24,20,34,164
1,1,67,23,14,13,117
0,1,54,9,15,7,85
2,1,59,12,16,35,122
1,1,109,25,15,5,154
2,1,73,18,10,35,136
1,1,65,24,14,19,122
2,1,94,10,11,22,137
2,1,106,9,12,31,158
0,1,18,3,0,11,32
1,1,17,1,1,36,55
1,1,12,0,0,22,34
1,1,11,1,0,19,31
1,1,16,1,0,32,49
1,1,12,3,1,13,29
1,1,14,4,1,27,46
1,1,11,3,1,37,52
1,2,17,2,0,18,37
1,2,18,4,1,39,62
1,2,20,4,0,32,56
1,2,15,0,0,28,43
0,2,11,4,0,12,27
1,2,19,5,1,35,60
1,2,15,0,1,26,42
1,2,11,4,0,31,46
1,2,19,2,1,33,55
1,2,12,4,1,29,46
1,2,15,5,1,16,37
1,2,14,4,1,21,40
1,2,19,4,1,17,41
0,2,10,2,1,12,25
0,2,10,0,0,11,21
1,2,20,4,1,33,58
0,2,10,1,0,12,23
0,2,73,12,5,5,95
1,2,95,15,4,19,133
1,2,81,19,3,13,116
1,2,119,25,10,9,163
1,2,80,10,4,15,109
1,2,102,24,3,16,145
0,2,68,17,6,10,101
3,2,109,40,38,0,187
3,2,124,25,31,1,181
3,2,126,22,21,1,170
3,2,120,31,29,5,185
3,2,101,20,47,5,173
3,2,139,40,48,2,229
1,2,116,23,23,4,166
1,2,101,14,24,0,139
3,2,137,40,21,5,203
3,2,131,26,36,0,193
3,2,114,27,45,4,190
2,2,102,14,46,1,163
3,2,116,24,32,5,177
1,2,29,10,21,12,72
0,2,41,12,15,10,78
1,2,41,9,7,27,84
2,2,90,25,26,10,151
1,2,64,25,17,20,126
2,2,64,10,17,23,114
2,2,69,17,5,28,119
1,2,59,9,9,21,98
1,2,44,10,12,29,95
1,2,43,5,6,26,80
1,2,65,7,10,21,103
1,2,29,5,12,21,67
1,2,24,9,8,20,61
1,2,44,6,4,26,80
1,2,35,10,12,24,81
1,2,43,10,15,21,89
1,2,45,17,24,11,97
3,2,108,21,37,14,180
2,2,53,19,33,9,114
2,2,75,23,31,13,142
1,2,70,18,5,19,112
1,2,52,25,15,19,111
1,2,9,18,24,9,60
1,2,47,21,9,18,95
3,2,116,20,17,19,172
0,2,65,14,6,9,94
1,2,93,12,13,13,131
3,2,100,21,45,9,175
3,2,121,24,31,6,182
3,2,110,15,50,5,180
2,2,103,17,28,5,153
3,2,136,38,20,5,199
3,2,119,22,32,9,182
3,2,132,17,36,5,190
3,2,147,10,41,5,203
3,2,111,12,44,6,173
2,2,102,27,32,5,166
3,2,137,25,29,7,198
2,2,71,17,15,31,134
1,2,64,25,11,15,115
2,2,70,16,15,29,130
2,2,91,9,11,32,143
2,2,95,6,11,35,147
2,2,76,16,10,31,133
1,2,87,17,18,7,129
2,2,63,22,12,29,126
1,2,56,17,20,8,101
3,2,102,18,19,29,168
1,2,60,23,10,13,106
2,2,88,6,18,25,137
2,2,104,15,10,32,161
1,2,16,1,1,26,44
0,2,12,1,0,12,25
1,2,16,1,0,29,46
1,2,13,5,0,31,49
1,2,20,1,1,27,49
1,2,18,0,0,29,47
1,2,16,3,1,26,46
1,2,18,0,0,21,39
1,3,11,5,0,24,40
0,3,13,1,0,10,24
1,3,10,1,0,26,37
1,3,19,5,1,22,47
0,3,20,0,0,10,30
1,3,16,4,1,39,60
0,3,19,1,1,11,32
1,3,20,4,0,38,62
1,3,15,1,1,15,32
1,3,10,0,0,33,43
1,3,20,5,0,24,49
1,3,12,2,1,35,50
1,3,10,4,1,37,52
1,3,15,4,0,38,57
1,3,19,0,1,39,59
1,3,16,4,0,35,55
1,3,20,3,1,35,59
1,3,118,1,0,4,123
1,3,89,20,4,17,130
1,3,120,18,6,13,157
1,3,85,7,3,18,113
1,3,99,8,2,14,123
0,3,59,25,2,7,93
0,3,58,25,2,5,90
3,3,113,40,36,4,193
3,3,113,16,50,2,181
3,3,121,27,50,4,202
3,3,150,17,28,0,195
3,3,136,29,23,0,188
3,3,142,32,27,2,203
3,3,106,32,42,2,182
1,3,103,21,20,0,144
3,3,131,19,26,1,177
3,3,133,23,21,3,180
3,3,123,17,50,1,191
3,3,124,21,35,2,182
3,3,136,26,20,4,186
2,3,92,10,39,19,160
1,3,82,7,13,19,121
1,3,42,2,28,27,99
1,3,24,17,17,9,67
1,3,42,19,17,12,90
2,3,100,12,5,23,140
1,3,11,25,30,22,88
1,3,27,7,10,22,66
1,3,38,7,11,20,76
1,3,49,10,6,27,92
1,3,66,9,7,28,110
1,3,70,8,3,22,103
1,3,58,7,6,27,98
1,3,53,9,13,29,104
1,3,22,5,6,26,59
1,3,40,10,11,28,89
0,3,58,13,10,12,93
1,3,60,25,24,17,126
1,3,25,11,24,17,77
1,3,22,28,11,18,79
1,3,6,11,37,15,69
2,3,92,18,34,18,162
3,3,97,17,38,20,172
2,3,92,18,31,6,147
1,3,74,12,17,16,119
0,3,67,22,7,5,101
1,3,84,20,25,15,144
3,3,144,15,42,8,209
3,3,120,11,47,7,185
2,3,108,10,36,6,160
3,3,141,13,50,6,210
3,3,121,37,29,8,195
3,3,142,40,22,6,210
3,3,137,23,28,7,195
2,3,117,10,27,8,162
2,3,100,16,37,7,160
3,3,148,11,42,8,209
3,3,148,27,39,6,220
2,3,65,18,20,21,124
0,3,75,9,14,6,104
2,3,85,15,20,29,149
1,3,57,21,20,18,116
1,3,50,7,13,30,100
2,3,87,21,14,34,156
0,3,64,24,11,6,105
1,3,76,6,18,14,114
0,3,69,11,12,8,100
1,3,76,9,17,14,116
1,3,94,8,15,5,122
2,3,104,10,16,33,163
2,3,98,13,13,33,157
1,3,13,5,0,18,36
0,3,17,1,0,11,29
1,3,18,2,1,34,55
1,3,11,1,0,35,47
0,3,17,4,0,11,32
1,3,17,1,1,23,42
1,3,17,2,0,23,42
1,3,16,4,1,30,51
1,4,15,5,1,23,44
1,4,18,0,0,31,49
1,4,10,1,0,17,28
1,4,13,2,0,32,47
1,4,16,1,0,38,55
1,4,11,4,0,32,47
1,4,12,2,0,26,40
1,4,14,2,1,14,31
1,4,18,2,0,37,57
1,4,17,1,1,22,41
1,4,12,3,0,29,44
1,4,20,5,0,30,55
1,4,17,5,1,19,42
1,4,12,0,1,33,46
1,4,19,1,0,20,40
1,4,11,4,1,38,54
1,4,14,5,0,39,58
1,4,102,20,4,12,138
1,4,92,4,6,18,120
1,4,54,14,10,16,94
0,4,55,15,1,10,81
0,4,64,27,5,5,101
1,4,52,13,5,15,85
0,4,73,11,4,3,91
3,4,106,27,45,5,183
3,4,145,21,40,5,211
3,4,133,19,28,5,185
3,4,117,31,49,0,197
3,4,146,17,34,0,197
3,4,101,35,42,3,181
2,4,103,28,32,1,164
3,4,150,10,26,0,186
3,4,135,23,48,0,206
2,4,104,10,48,2,164
3,4,144,39,50,1,234
3,4,132,10,49,0,191
3,4,142,19,31,1,193
1,4,45,4,30,29,108
0,4,27,24,10,5,66
1,4,85,3,14,16,118
2,4,84,11,27,26,148
1,4,90,4,10,20,124
1,4,13,19,39,12,83
1,4,11,1,37,9,58
1,4,57,10,4,27,98
1,4,52,10,9,23,94
1,4,38,7,13,21,79
1,4,35,7,15,24,81
1,4,60,10,12,21,103
2,4,70,10,3,30,113
1,4,34,8,6,30,78
1,4,44,6,4,27,81
1,4,21,5,4,25,55
1,4,106,10,11,11,138
2,4,82,30,32,10,154
1,4,57,12,9,17,95
1,4,60,18,21,10,109
2,4,79,17,34,8,138
1,4,78,29,22,13,142
2,4,69,14,32,18,133
1,4,84,25,5,9,123
1,4,62,11,28,5,106
1,4,33,17,22,18,90
1,4,14,21,23,6,64
3,4,127,27,40,5,199
3,4,136,10,27,7,180
3,4,148,14,37,9,208
3,4,122,16,28,6,172
3,4,132,12,45,9,198
3,4,136,29,29,10,204
3,4,103,33,48,10,194
3,4,132,37,23,10,202
3,4,136,39,39,6,220
3,4,120,24,36,5,185
3,4,126,34,38,9,207
1,4,80,22,14,18,134
2,4,99,9,15,29,152
1,4,81,21,19,7,128
2,4,87,9,16,26,138
2,4,80,17,13,30,140
1,4,91,18,18,9,136
1,4,90,19,15,13,137
2,4,107,19,10,23,159
2,4,98,11,14,27,150
2,4,98,18,20,22,158
1,4,102,5,12,17,136
2,4,62,13,16,28,119
2,4,101,15,12,35,163
1,4,17,5,1,16,39
1,4,10,4,1,37,52
1,4,16,4,0,35,55
1,4,17,2,0,17,36
1,4,17,0,0,27,44
1,4,17,4,1,25,47
1,4,15,2,0,15,32
0,4,20,0,1,12,33
1,5,16,3,0,28,47
1,5,13,2,1,28,44
1,5,15,5,0,26,46
1,5,15,2,1,16,34
1,5,12,3,0,26,41
1,5,15,5,0,27,47
1,5,20,2,0,17,39
1,5,12,2,0,16,30
1,5,19,1,0,38,58
1,5,16,1,1,32,50
0,5,12,0,0,11,23
1,5,16,5,1,29,51
1,5,19,5,1,18,43
1,5,11,0,0,15,26
1,5,15,4,1,17,37
1,5,20,1,0,23,44
1,5,10,4,0,36,50
1,5,39,14,0,15,68
0,5,33,7,3,10,53
1,5,77,8,7,15,107
1,5,80,18,6,11,115
1,5,53,11,7,15,86
1,5,73,17,6,13,109
1,5,77,20,4,13,114
0,5,76,14,1,12,103
1,5,58,14,0,15,87
1,5,57,18,7,13,95
0,5,80,16,0,10,106
1,5,38,7,1,13,59
0,5,53,20,6,12,91
0,5,30,9,7,10,56
0,5,50,19,4,10,83
1,5,31,14,3,14,62
0,5,28,18,5,10,61
0,5,31,15,4,12,62
0,5,52,19,0,10,81
1,5,42,9,2,13,66
3,5,151,55,27,2,235
3,5,180,69,29,1,279
3,5,149,41,23,3,216
3,5,167,60,27,3,257
3,5,134,45,22,3,204
3,5,180,62,26,4,272
3,5,156,54,25,3,238
3,5,171,60,18,1,250
3,5,174,53,10,3,240
3,5,154,61,16,3,234
3,5,161,53,11,1,226
3,5,148,48,13,2,211
3,5,136,60,27,2,225
3,5,143,68,16,0,227
3,5,152,51,22,2,227
3,5,132,58,15,4,209
3,5,155,58,15,4,232
3,5,144,62,12,3,221
3,5,161,51,20,1,233
3,5,137,46,13,2,198
3,5,149,61,16,1,227
3,5,158,46,20,1,225
3,5,134,65,22,0,221
3,5,134,65,10,2,211
0,5,73,24,4,0,101
1,5,64,23,21,1,109
1,5,51,27,25,2,105
1,5,80,22,17,0,119
0,5,61,26,8,0,95
0,5,75,24,8,0,107
1,5,82,20,15,2,119
1,5,53,28,21,1,103
0,5,68,29,14,0,111
1,5,63,28,22,0,113
1,5,76,30,20,1,127
0,5,66,23,10,0,99
0,5,50,23,1,0,74
1,5,60,29,22,2,113
1,5,75,26,11,0,112
1,5,81,22,18,2,123
0,5,33,6,0,4,43
1,5,21,5,6,15,47
0,5,22,7,1,2,32
1,5,31,6,0,15,52
0,5,41,8,3,2,54
0,5,24,6,5,11,46
0,5,45,6,6,10,67
0,5,24,11,6,2,43
0,5,47,6,2,12,67
0,5,46,1,1,4,52
0,5,26,3,2,3,34
1,5,20,4,0,39,63
1,5,20,1,1,27,49
1,5,19,0,1,17,37
1,5,11,3,1,19,34
1,5,17,5,1,31,54
0,5,19,4,0,12,35
1,5,11,1,0,38,50
1,5,12,0,0,17,29
1,6,18,0,0,27,45
1,6,19,4,0,14,37
1,6,13,2,0,28,43
1,6,18,4,1,23,46
0,6,20,0,0,11,31
1,6,11,4,1,22,38
1,6,15,2,0,18,35
1,6,16,3,0,34,53
1,6,11,2,0,18,31
1,6,17,4,1,38,60
1,6,20,4,1,28,53
1,6,19,0,1,37,57
1,6,10,2,1,34,47
1,6,19,0,0,17,36
1,6,15,0,0,30,45
1,6,10,2,0,31,43
1,6,18,3,0,17,38
1,6,97,22,4,18,141
1,6,111,12,9,17,149
1,6,108,10,5,17,140
1,6,74,24,10,20,128
1,6,114,4,8,20,146
1,6,91,16,5,11,123
1,6,66,3,9,19,97
1,6,104,32,23,5,164
3,6,128,18,31,3,180
3,6,127,24,27,0,178
3,6,130,31,22,0,183
2,6,108,13,38,1,160
3,6,116,22,37,2,177
3,6,143,28,27,4,202
3,6,118,32,21,5,176
3,6,121,35,32,0,188
3,6,109,28,39,2,178
3,6,135,11,23,5,174
2,6,100,30,29,2,161
3,6,138,32,26,4,200
1,6,29,9,21,23,82
1,6,36,17,7,30,90
2,6,42,9,37,28,116
0,6,80,6,12,6,104
1,6,37,21,28,6,92
2,6,44,17,27,30,118
0,6,25,12,13,5,55
1,6,36,9,9,30,84
1,6,63,7,10,29,109
1,6,20,5,13,22,60
1,6,53,8,6,23,90
1,6,41,7,5,26,79
1,6,36,9,13,29,87
1,6,65,10,8,22,105
1,6,55,6,5,27,93
2,6,63,8,15,30,116
1,6,19,26,32,18,95
1,6,84,11,11,9,115
3,6,110,23,34,9,176
1,6,46,20,18,5,89
1,6,67,12,10,20,109
1,6,42,25,20,19,106
1,6,87,17,18,6,128
1,6,45,24,31,11,111
2,6,80,26,35,6,147
1,6,83,18,6,15,122
1,6,68,19,15,11,113
3,6,101,37,48,9,195
3,6,149,32,29,10,220
3,6,136,21,33,9,199
1,6,105,20,23,7,155
1,6,125,12,20,8,165
3,6,125,14,26,5,170
3,6,118,28,23,8,177
3,6,114,32,45,6,197
3,6,123,37,46,8,214
1,6,115,23,22,7,167
3,6,111,25,35,10,181
0,6,66,8,11,9,94
2,6,103,12,17,23,155
2,6,94,14,14,24,146
1,6,105,23,15,18,161
2,6,53,22,14,35,124
2,6,74,10,12,32,128
2,6,71,24,15,26,136
2,6,61,21,15,32,129
1,6,101,25,18,8,152
1,6,104,22,10,14,150
1,6,79,20,15,18,132
1,6,70,20,11,14,115
2,6,74,16,14,34,138
1,6,20,5,0,21,46
1,6,16,0,0,36,52
1,6,14,3,0,20,37
1,6,14,1,1,30,46
0,6,17,0,1,12,30
1,6,14,0,0,14,28
1,6,18,5,0,40,63
1,6,17,2,0,18,37
1,7,14,1,1,35,51
1,7,14,2,1,26,43
1,7,16,0,1,37,54
1,7,14,4,1,32,51
0,7,19,5,0,12,36
1,7,11,0,1,31,43
1,7,12,0,0,32,44
1,7,12,3,0,32,47
1,7,18,4,1,31,54
1,7,17,4,1,20,42
1,7,17,0,0,22,39
0,7,19,2,1,12,34
1,7,18,2,1,19,40
1,7,19,5,0,26,50
1,7,19,5,1,35,60
1,7,18,0,0,20,38
1,7,16,0,0,30,46
1,7,114,30,9,7,160
1,7,102,17,2,14,135
1,7,55,4,7,13,79
1,7,82,2,4,14,102
1,7,66,16,9,19,110
1,7,86,5,1,13,105
1,7,108,24,2,19,153
3,7,112,30,26,0,168
3,7,147,31,46,0,224
3,7,116,20,40,2,178
3,7,138,13,21,5,177
3,7,132,25,40,2,199
3,7,124,14,31,4,173
1,7,106,27,25,1,159
2,7,104,24,29,5,162
3,7,140,31,21,4,196
3,7,121,35,37,3,196
3,7,135,23,37,5,200
3,7,149,20,30,5,204
3,7,117,14,39,0,170
1,7,39,8,23,13,83
1,7,40,14,18,21,93
1,7,49,1,35,18,103
1,7,38,12,35,25,110
1,7,26,15,25,6,72
2,7,93,14,10,25,142
2,7,54,24,37,20,135
1,7,32,6,10,23,71
1,7,43,7,12,23,85
1,7,23,6,15,20,64
1,7,26,5,8,25,64
1,7,55,7,8,27,97
2,7,70,10,8,25,113
1,7,66,10,3,29,108
2,7,66,7,15,26,114
1,7,46,6,7,21,80
1,7,47,26,6,20,99
1,7,75,20,7,11,113
1,7,76,29,15,19,139
2,7,56,14,38,12,120
1,7,19,26,36,17,98
0,7,29,18,10,9,66
1,7,15,12,18,15,60
2,7,53,27,27,17,124
2,7,95,22,28,9,154
1,7,27,27,32,10,96
2,7,68,28,31,15,142
1,7,120,14,25,8,167
3,7,144,28,24,8,204
3,7,112,31,43,8,194
3,7,149,28,20,10,207
3,7,131,29,34,8,202
3,7,104,31,41,9,185
3,7,141,30,27,7,205
3,7,117,10,47,9,183
3,7,112,13,37,6,168
3,7,127,40,39,8,214
3,7,131,15,31,6,183
0,7,66,8,10,11,95
2,7,61,23,18,34,136
2,7,55,25,13,26,119
1,7,85,23,20,6,134
1,7,75,20,19,19,133
2,7,58,17,20,22,117
2,7,60,23,11,26,120
1,7,80,21,11,7,119
2,7,74,9,14,35,132
1,7,57,14,11,16,98
0,7,73,9,13,5,100
2,7,80,25,19,26,150
2,7,82,13,12,21,128
1,7,15,4,0,27,46
1,7,20,2,0,29,51
1,7,12,2,0,39,53
1,7,10,4,1,13,28
1,7,16,0,1,29,46
1,7,18,0,0,34,52
1,7,11,5,1,19,36
0,7,16,1,0,12,29
0,1,13,3,1,12,29
1,1,19,2,0,22,43
1,1,13,3,0,39,55
1,1,12,0,0,24,36
0,1,10,3,1,12,26
1,1,11,4,0,38,53
1,1,18,4,0,31,53
1,1,19,1,0,34,54
1,1,18,1,0,27,46
1,1,13,0,0,26,39
1,1,12,2,0,35,49
0,1,15,4,0,12,31
1,1,10,5,0,33,48
1,1,14,0,0,15,29
1,1,16,0,0,16,32
1,1,15,3,1,26,45
1,1,20,4,0,34,58
1,1,82,20,10,11,123
1,1,99,7,3,6,115
1,1,74,29,9,4,116
1,1,94,1,1,14,110
1,1,63,12,10,17,102
1,1,101,4,3,12,120
1,1,106,9,3,10,128
1,1,112,15,24,1,152
3,1,148,26,25,0,199
3,1,115,20,31,3,169
1,1,125,11,24,0,160
3,1,140,38,38,0,216
3,1,150,17,35,5,207
3,1,149,11,42,2,204
3,1,150,22,38,3,213
3,1,147,32,25,4,208
3,1,138,39,45,4,226
3,1,149,16,49,1,215
3,1,139,10,50,2,201
3,1,109,25,49,2,185
2,1,84,24,12,28,148
0,1,38,8,6,5,57
1,1,45,16,6,21,88
1,1,57,4,36,14,111
2,1,84,12,6,28,130
2,1,55,25,33,21,134
1,1,14,15,5,21,55
1,1,26,8,11,20,65
1,1,60,10,9,27,106
1,1,34,6,7,25,72
1,1,22,9,8,26,65
1,1,59,10,11,30,110
1,1,48,6,14,28,96
1,1,46,9,11,23,89
1,1,37,9,8,20,74
1,1,67,9,11,21,108
1,1,32,19,39,9,99
1,1,63,12,22,5,102
1,1,32,29,25,11,97
2,1,83,22,40,20,165
1,1,40,14,31,19,104
3,1,101,22,39,19,181
2,1,62,29,31,11,133
1,1,20,19,25,8,72
0,1,42,22,5,9,78
1,1,37,17,12,16,82
1,1,95,12,20,15,142
3,1,137,14,41,10,202
3,1,122,21,20,10,173
3,1,104,19,39,9,171
3,1,147,21,40,9,217
3,1,105,38,34,7,184
3,1,124,23,46,5,198
3,1,135,18,20,5,178
3,1,107,35,23,8,173
1,1,109,21,24,10,164
3,1,136,32,26,8,202
3,1,134,23,49,8,214
2,1,90,20,11,25,146
1,1,104,5,16,16,141
0,1,60,21,13,6,100
1,1,104,22,11,13,150
2,1,54,23,10,25,112
2,1,68,6,15,34,123
1,1,88,13,19,19,139
1,1,64,22,16,16,118
2,1,58,24,14,24,120
0,1,67,19,12,9,107
1,1,73,20,18,7,118
3,1,109,25,16,20,170
2,1,63,15,11,23,112
1,1,19,4,1,26,50
1,1,15,1,0,34,50
1,1,15,5,1,14,35
1,1,19,3,1,33,56
0,1,18,4,0,11,33
1,1,14,1,0,27,42
1,1,19,0,0,37,56
1,1,19,0,0,29,48
1,2,18,1,0,30,49
1,2,19,3,0,18,40
1,2,15,2,1,34,52
1,2,17,0,1,14,32
1,2,12,0,0,33,45
1,2,20,0,1,20,41
1,2,10,2,0,18,30
1,2,13,3,0,31,47
1,2,10,0,1,38,49
1,2,19,1,1,28,49
1,2,19,4,0,16,39
1,2,16,1,0,15,32
1,2,17,1,0,34,52
1,2,19,1,0,21,41
1,2,10,1,0,39,50
1,2,16,4,0,15,35
1,2,13,0,0,16,29
1,2,98,5,1,17,121
0,2,65,10,3,8,86
1,2,98,17,0,20,135
0,2,60,20,5,6,91
1,2,110,18,10,11,149
1,2,70,13,4,13,100
1,2,96,12,7,17,132
3,2,129,31,36,1,197
3,2,146,28,47,3,224
3,2,137,23,27,0,187
3,2,131,28,24,0,183
3,2,134,10,44,0,188
1,2,109,25,24,0,158
3,2,108,35,22,3,168
3,2,146,14,37,2,199
3,2,147,21,41,5,214
3,2,110,34,35,0,179
3,2,110,40,50,2,202
1,2,123,12,22,3,160
3,2,145,25,20,5,195
2,2,82,15,16,29,142
1,2,62,2,7,22,93
2,2,92,8,11,21,132
1,2,35,22,22,18,97
1,2,66,25,13,13,117
1,2,50,2,25,12,89
1,2,50,22,24,7,103
1,2,50,8,5,24,87
1,2,55,5,5,21,86
1,2,51,10,14,24,99
1,2,34,8,14,21,77
1,2,25,7,5,20,57
1,2,59,7,9,21,96
1,2,38,10,9,24,81
2,2,70,10,9,23,112
1,2,63,8,13,22,106
1,2,6,24,12,13,55
1,2,108,17,16,16,157
1,2,41,20,32,12,105
1,2,54,10,20,9,93
0,2,60,19,14,7,100
1,2,102,11,9,11,133
1,2,50,24,30,5,109
1,2,25,24,19,10,78
1,2,90,25,18,20,153
2,2,86,13,27,11,137
1,2,44,19,17,9,89
3,2,126,24,35,8,193
1,2,146,26,42,9,223
3,2,117,28,33,10,188
3,2,144,36,49,10,239
3,2,137,19,23,9,188
3,2,118,19,48,5,190
3,2,119,27,28,8,182
1,2,149,26,43,5,223
3,2,117,34,36,10,197
3,2,124,30,44,10,208
3,2,141,36,48,5,230
2,2,78,6,11,28,123
2,2,102,23,16,24,165
2,2,104,18,18,23,163
1,2,95,9,19,7,130
1,2,105,13,12,20,150
3,2,100,18,16,34,168
1,2,80,14,20,15,129
1,2,86,8,19,7,120
1,2,108,20,14,15,157
0,2,69,13,13,8,103
0,2,64,14,10,6,94
1,2,71,14,17,10,112
2,2,61,9,18,24,112
1,2,11,4,0,31,46
1,2,17,5,0,14,36
1,2,15,5,0,18,38
1,2,14,2,0,40,56
1,2,12,2,1,28,43
1,2,18,0,1,40,59
1,2,14,5,0,13,32
1,2,18,1,0,26,45
1,3,14,0,0,34,48
1,3,17,5,0,23,45
1,3,19,1,1,18,39
0,3,15,5,1,12,33
1,3,13,2,1,26,42
1,3,15,3,0,32,50
1,3,15,0,1,13,29
0,3,18,5,1,12,36
1,3,17,1,0,29,47
1,3,10,4,0,19,33
1,3,15,0,0,18,33
1,3,11,0,0,35,46
1,3,20,5,1,34,60
1,3,15,5,1,32,53
1,3,16,4,1,37,58
0,3,14,1,0,12,27
1,3,16,4,0,18,38
0,3,56,21,3,0,80
1,3,78,11,10,18,117
1,3,82,29,0,20,131
1,3,102,15,2,7,126
1,3,69,14,6,18,107
1,3,87,24,6,19,136
1,3,84,16,10,5,115
3,3,109,38,34,5,186
3,3,147,38,23,3,211
3,3,135,19,48,5,207
3,3,101,23,41,5,170
3,3,138,21,28,1,188
3,3,136,20,32,1,189
3,3,123,19,25,5,172
3,3,108,30,46,5,189
3,3,128,15,43,5,191
3,3,129,37,41,1,208
3,3,127,18,28,3,176
3,3,142,37,46,3,228
3,3,149,26,46,1,222
2,3,77,13,7,23,120
1,3,37,16,13,29,95
1,3,79,8,16,12,115
1,3,97,2,16,7,122
1,3,22,8,31,8,69
1,3,31,23,19,12,85
1,3,49,22,16,5,92
1,3,32,5,3,21,61
1,3,40,6,11,28,85
1,3,42,6,10,21,79
1,3,37,9,7,25,78
1,3,45,5,5,24,79
1,3,64,10,4,28,106
1,3,33,8,6,23,70
1,3,34,6,12,27,79
1,3,40,9,5,20,74
1,3,64,19,22,12,117
3,3,108,24,34,7,173
2,3,108,17,33,7,165
1,3,50,23,21,11,105
1,3,16,21,10,16,63
2,3,91,22,34,8,155
2,3,89,19,37,18,163
1,3,108,12,23,8,151
1,3,73,29,23,7,132
2,3,76,28,39,14,157
1,3,19,15,20,17,71
3,3,102,37,48,9,196
3,3,115,36,41,8,200
3,3,142,23,23,6,194
3,3,134,15,29,8,186
3,3,146,18,49,9,222
3,3,126,24,48,9,207
3,3,138,18,27,6,189
3,3,129,13,43,6,191
3,3,127,35,23,10,195
3,3,144,20,22,7,193
3,3,117,19,31,7,174
1,3,87,10,13,16,126
2,3,87,6,18,30,141
2,3,97,18,10,24,149
1,3,71,21,14,12,118
1,3,96,24,18,10,148
2,3,90,7,17,31,145
2,3,74,6,12,34,126
1,3,59,7,15,20,101
2,3,87,11,16,28,142
1,3,62,22,20,20,124
0,3,71,16,14,9,110
1,3,98,9,15,18,140
1,3,93,8,10,16,127
1,3,17,4,0,36,57
1,3,16,1,1,29,47
0,3,15,2,0,10,27
1,3,10,3,1,23,37
1,3,12,4,0,31,47
1,3,20,1,1,24,46
1,3,11,0,1,23,35
1,3,14,1,1,17,33
1,4,12,5,1,38,56
1,4,15,4,1,29,49
1,4,12,4,0,40,56
1,4,11,5,0,22,38
1,4,14,5,1,21,41
1,4,14,3,0,39,56
0,4,10,4,1,11,26
1,4,11,0,0,16,27
1,4,12,3,0,39,54
1,4,11,0,1,36,48
1,4,16,2,0,35,53
1,4,17,3,1,36,57
1,4,13,1,1,13,28
1,4,14,5,0,19,38
1,4,17,5,1,15,38
1,4,19,3,0,13,35
0,4,19,3,1,12,35
0,4,54,15,10,8,87
0,4,107,0,1,2,110
1,4,116,20,5,14,155
0,4,78,2,4,9,93
1,4,111,22,0,12,145
1,4,85,27,7,17,136
1,4,95,5,9,20,129
3,4,143,33,27,1,204
3,4,133,40,37,0,210
3,4,123,37,34,4,198
3,4,133,34,36,1,204
1,4,101,20,42,4,167
3,4,145,10,37,0,192
3,4,141,39,40,5,225
3,4,134,12,22,2,170
2,4,126,10,26,4,166
3,4,136,22,31,0,189
3,4,128,26,42,4,200
2,4,106,12,28,4,150
3,4,140,27,36,2,205
2,4,40,20,37,28,125
1,4,13,25,33,12,83
1,4,18,22,26,10,76
2,4,59,5,36,12,112
1,4,48,9,30,14,101
1,4,77,23,14,20,134
1,4,17,13,13,27,70
1,4,36,5,14,25,80
1,4,60,10,3,28,101
1,4,34,5,4,29,72
1,4,63,5,6,20,94
1,4,48,10,13,23,94
1,4,44,5,5,21,75
1,4,62,5,14,23,104
1,4,38,8,15,27,88
1,4,26,6,9,29,70
1,4,78,23,16,13,130
3,4,116,21,22,17,176
1,4,94,13,11,16,134
1,4,52,19,26,10,107
0,4,70,13,12,10,105
1,4,34,17,21,14,86
1,4,16,18,40,6,80
1,4,24,20,15,17,76
1,4,21,15,33,12,81
1,4,100,10,18,7,135
1,4,117,22,11,5,155
1,4,145,30,40,8,223
3,4,113,38,45,7,203
3,4,110,31,37,7,185
3,4,126,15,26,6,173
2,4,100,15,29,7,151
3,4,147,28,29,10,214
3,4,146,22,50,10,228
3,4,148,23,27,5,203
3,4,149,17,41,9,216
3,4,136,32,41,7,216
2,4,101,22,33,9,165
2,4,87,18,13,34,152
0,4,50,21,14,9,94
2,4,63,23,19,34,139
0,4,73,9,11,5,98
2,4,78,13,20,25,136
1,4,71,22,12,14,119
1,4,80,17,11,15,123
2,4,62,21,10,35,128
2,4,100,17,16,33,166
1,4,95,15,18,9,137
2,4,102,14,15,34,165
2,4,68,12,15,32,127
1,4,74,5,19,5,103
1,4,15,4,1,21,41
1,4,16,0,1,24,41
0,4,12,0,0,12,24
1,4,12,5,0,23,40
1,4,15,2,1,14,32
1,4,10,3,0,23,36
1,4,16,2,0,35,53
1,4,13,3,0,22,38
1,5,13,0,0,32,45
1,5,11,1,0,27,39
1,5,17,1,0,32,50
1,5,11,2,0,17,30
0,5,14,1,1,11,27
1,5,17,2,0,33,52
1,5,15,2,1,38,56
1,5,13,4,1,24,42
0,5,11,5,1,11,28
1,5,12,3,0,22,37
1,5,15,1,0,26,42
1,5,13,0,1,34,48
1,5,17,5,0,15,37
1,5,20,3,1,26,50
1,5,18,4,0,30,52
1,5,12,1,1,19,33
0,5,20,0,0,12,32
0,5,29,10,0,12,51
0,5,39,20,1,10,70
1,5,76,9,7,13,105
1,5,33,17,0,13,63
0,5,64,14,1,12,91
0,5,44,7,1,11,63
1,5,53,8,4,15,80
1,5,75,6,7,13,101
0,5,60,11,4,10,85
1,5,35,14,2,14,65
1,5,75,20,6,15,116
0,5,27,10,2,12,51
1,5,61,20,7,14,102
1,5,72,20,5,15,112
1,5,43,18,6,14,81
1,5,54,10,4,14,82
1,5,30,12,1,14,57
0,5,72,8,6,12,98
1,5,55,17,7,15,94
1,5,36,20,0,13,69
3,5,168,55,10,0,233
3,5,135,61,28,2,226
3,5,168,68,27,2,265
3,5,139,44,16,1,200
3,5,156,63,12,3,234
3,5,141,51,27,3,222
3,5,144,44,16,3,207
3,5,132,65,23,0,220
3,5,180,48,17,2,247
3,5,140,67,20,4,231
3,5,163,62,12,0,237
3,5,148,70,15,0,233
3,5,134,47,22,3,206
3,5,162,51,13,0,226
3,5,136,49,15,1,201
3,5,147,52,26,0,225
3,5,174,54,25,1,254
3,5,135,69,20,1,225
3,5,142,55,21,1,219
3,5,144,59,14,2,219
3,5,180,49,17,0,246
3,5,153,59,20,4,236
3,5,139,43,27,3,212
3,5,179,60,12,0,251
0,5,76,21,6,1,104
1,5,59,25,19,1,104
0,5,51,20,12,1,84
1,5,78,24,19,2,123
0,5,50,24,11,0,85
0,5,59,25,8,0,92
0,5,90,21,0,0,111
1,5,79,26,21,2,128
0,5,56,21,4,1,82
0,5,70,25,11,2,108
1,5,54,27,21,2,104
0,5,53,22,13,2,90
0,5,59,27,5,2,93
1,5,63,30,21,0,114
1,5,87,21,16,0,124
1,5,71,26,19,1,117
1,5,32,5,5,13,55
0,5,36,6,7,2,51
0,5,35,10,0,2,47
0,5,40,10,5,10,65
0,5,44,6,1,3,54
0,5,40,6,1,3,50
0,5,45,2,7,7,61
0,5,44,2,6,5,57
0,5,33,4,4,5,46
1,5,22,5,3,13,43
0,5,33,5,5,1,44
1,5,10,0,0,29,39
1,5,19,3,1,35,58
1,5,10,4,0,30,44
1,5,12,3,1,25,41
1,5,12,1,0,40,53
1,5,20,2,0,19,41
0,5,18,4,1,11,34
1,5,19,1,1,37,58
1,6,13,2,0,25,40
1,6,16,4,1,15,36
1,6,10,4,1,16,31
1,6,18,3,0,19,40
0,6,15,5,0,10,30
1,6,14,2,1,22,39
1,6,15,0,0,15,30
1,6,17,5,0,21,43
0,6,14,0,1,12,27
0,6,10,1,0,11,22
1,6,18,5,0,18,41
0,6,12,4,0,11,27
1,6,17,0,1,30,48
1,6,20,1,0,28,49
1,6,19,5,1,38,63
1,6,15,0,0,36,51
1,6,10,2,0,30,42
1,6,74,4,4,13,95
1,6,96,29,6,17,148
1,6,109,16,6,12,143
1,6,113,6,9,10,138
1,6,90,24,8,20,142
1,6,106,19,10,17,152
1,6,96,7,6,4,113
3,6,102,21,42,3,168
3,6,140,35,50,0,225
3,6,105,33,29,4,171
3,6,134,26,27,1,188
3,6,123,35,45,1,204
3,6,128,31,26,0,185
3,6,105,32,43,0,180
3,6,137,13,31,5,186
3,6,148,37,46,2,233
2,6,105,14,35,2,156
3,6,148,17,42,5,212
3,6,116,22,30,3,171
3,6,143,28,46,1,218
1,6,30,24,13,13,80
2,6,74,23,35,10,142
2,6,67,5,36,17,125
2,6,59,11,33,25,128
1,6,34,21,39,16,110
1,6,72,24,10,9,115
2,6,73,12,32,5,122
1,6,26,8,8,24,66
1,6,47,5,7,28,87
1,6,33,10,6,29,78
1,6,39,8,13,20,80
1,6,36,5,14,22,77
1,6,53,9,15,25,102
1,6,37,9,10,30,86
1,6,54,8,4,27,93
1,6,20,8,15,26,69
2,6,47,29,28,9,113
1,6,51,27,10,20,108
3,6,114,11,40,20,185
1,6,73,13,19,9,114
1,6,28,19,27,5,79
1,6,105,20,20,11,156
1,6,68,24,15,14,121
3,6,112,16,30,11,169
3,6,120,30,28,15,193
1,6,38,27,12,18,95
1,6,94,17,14,15,140
3,6,107,28,45,8,188
3,6,100,16,49,7,172
3,6,145,15,20,9,189
3,6,133,17,22,8,180
3,6,117,36,41,10,204
3,6,113,26,26,8,173
1,6,101,20,21,9,151
3,6,149,33,45,10,237
3,6,134,35,26,7,202
3,6,106,11,45,9,171
3,6,121,37,34,6,198
1,6,97,13,11,15,136
2,6,91,17,18,29,155
1,6,57,16,13,19,105
1,6,110,10,10,20,150
2,6,71,14,17,30,132
2,6,89,25,20,24,158
1,6,87,16,15,14,132
1,6,106,12,16,9,143
1,6,78,10,19,20,127
2,6,61,10,16,27,114
2,6,74,19,15,24,132
2,6,56,20,11,25,112
1,6,106,22,16,18,162
0,6,10,1,1,12,24
1,6,12,4,1,33,50
1,6,16,4,0,16,36
1,6,18,1,0,18,37
1,6,19,2,0,36,57
1,6,18,4,1,35,58
1,6,17,0,0,31,48
1,6,18,1,0,16,35
1,7,15,4,0,37,56
1,7,11,5,0,14,30
1,7,11,5,0,22,38
1,7,12,2,1,37,52
1,7,18,1,1,34,54
0,7,19,1,0,11,31
1,7,11,4,1,26,42
1,7,18,3,0,28,49
1,7,12,4,1,37,54
1,7,11,1,1,29,42
1,7,19,5,1,29,54
0,7,18,4,0,11,33
1,7,16,4,0,29,49
1,7,19,4,1,33,57
0,7,15,3,1,12,31
1,7,16,4,1,28,49
1,7,11,4,0,20,35
1,7,93,4,1,16,114
1,7,114,12,7,18,151
1,7,56,7,5,20,88
1,7,92,23,3,19,137
1,7,99,6,6,7,118
1,7,108,14,6,9,137
1,7,66,20,2,16,104
3,7,147,26,44,5,222
3,7,139,27,29,1,196
3,7,119,31,36,5,191
1,7,114,30,21,2,167
1,7,103,27,21,4,155
2,7,105,17,29,4,155
3,7,124,29,41,1,195
3,7,118,19,34,1,172
3,7,101,37,32,0,170
3,7,109,11,48,1,169
3,7,143,12,23,3,181
3,7,143,40,30,0,213
3,7,128,16,34,0,178
1,7,14,25,14,16,69
1,7,99,10,11,15,135
1,7,67,1,22,14,104
1,7,42,2,29,9,82
2,7,92,3,33,21,149
2,7,91,16,28,9,144
1,7,25,9,10,28,72
1,7,37,5,12,29,83
1,7,55,6,12,29,102
1,7,49,8,8,26,91
1,7,69,9,3,20,101
1,7,38,6,6,24,74
1,7,40,8,12,21,81
1,7,53,5,3,20,81
1,7,21,8,4,28,61
1,7,24,7,4,20,55
1,7,47,24,24,9,104
2,7,90,30,32,8,160
3,7,120,21,22,14,177
3,7,120,12,40,13,185
1,7,66,14,21,7,108
1,7,89,24,12,6,131
1,7,80,17,16,5,118
1,7,114,21,10,9,154
1,7,94,20,7,10,131
2,7,70,18,28,5,121
0,7,56,17,15,8,96
3,7,141,15,20,6,182
3,7,150,19,46,7,222
3,7,119,37,22,8,186
3,7,144,14,44,5,207
3,7,110,25,46,6,187
3,7,138,15,31,10,194
3,7,140,35,41,5,221
2,7,103,24,28,8,163
3,7,142,27,30,5,204
3,7,149,13,22,9,193
3,7,126,40,39,8,213
2,7,78,15,14,28,135
2,7,102,15,11,29,157
1,7,96,22,20,12,150
1,7,110,24,15,14,163
1,7,97,22,17,13,149
1,7,53,19,11,18,101
2,7,82,8,17,29,136
2,7,91,24,18,29,162
2,7,102,6,14,35,157
1,7,109,6,15,18,148
2,7,78,16,13,27,134
2,7,66,12,16,33,127
2,7,100,17,15,22,154
1,7,15,1,1,25,42
1,7,16,1,0,33,50
1,7,19,4,0,26,49
1,7,10,0,1,34,45
1,7,14,0,0,28,42
1,7,13,2,0,22,37
1,7,18,5,1,20,44
1,7,18,4,0,18,40
1,1,11,3,0,26,40
1,1,13,1,0,24,38
1,1,19,5,1,15,40
1,1,11,3,1,28,43
1,1,11,1,1,40,53
1,1,18,4,1,28,51
1,1,15,2,1,16,34
1,1,20,0,0,27,47
1,1,14,5,0,17,36
0,1,11,3,1,10,25
1,1,18,5,0,22,45
1,1,12,4,0,16,32
1,1,10,2,0,24,36
1,1,20,0,1,36,57
1,1,20,1,0,29,50
1,1,16,4,0,24,44
1,1,18,3,0,22,43
1,1,88,11,10,3,112
1,1,114,5,9,7,135
1,1,103,3,9,17,132
1,1,81,16,7,14,118
0,1,94,1,9,3,107
1,1,56,11,9,15,91
0,1,80,16,5,10,111
3,1,138,35,47,4,224
3,1,123,27,22,4,176
3,1,114,30,36,2,182
3,1,122,30,37,2,191
3,1,148,10,28,2,188
3,1,127,38,48,0,213
3,1,113,32,44,1,190
3,1,131,26,40,1,198
3,1,108,27,44,5,184
3,1,109,19,49,3,180
3,1,125,15,28,3,171
3,1,139,30,35,4,208
3,1,103,35,50,2,190
2,1,64,13,40,12,129
2,1,79,1,10,30,120
1,1,50,2,7,14,73
2,1,84,18,18,28,148
3,1,99,16,39,26,180
1,1,42,3,27,18,90
1,1,53,2,29,24,108
1,1,63,10,8,28,109
1,1,24,8,3,20,55
1,1,46,8,6,26,86
1,1,20,7,8,26,61
1,1,41,8,7,27,83
1,1,44,5,3,28,80
1,1,33,6,14,28,81
1,1,30,9,7,25,71
1,1,68,7,5,25,105
1,1,28,29,26,5,88
1,1,96,20,14,18,148
1,1,24,15,26,13,78
2,1,70,21,32,18,141
1,1,49,21,11,20,101
1,1,51,22,12,16,101
1,1,84,12,15,15,126
1,1,99,18,7,20,144
1,1,106,10,9,8,133
1,1,6,11,34,20,71
1,1,59,29,15,16,119
3,1,139,25,41,5,210
3,1,109,12,49,6,176
3,1,124,24,47,9,204
3,1,135,29,39,7,210
3,1,137,15,37,7,196
3,1,119,28,46,9,202
3,1,127,21,28,5,181
3,1,109,37,44,9,199
3,1,145,27,35,7,214
3,1,133,36,28,6,203
3,1,138,19,36,5,198
1,1,73,5,20,10,108
2,1,83,11,14,33,141
1,1,89,8,10,19,126
2,1,99,19,18,24,160
0,1,54,17,14,8,93
0,1,58,18,14,6,96
0,1,56,16,12,9,93
1,1,77,6,20,5,108
1,1,85,6,18,17,126
2,1,105,14,13,32,164
2,1,96,21,11,24,152
1,1,66,22,17,16,121
1,1,88,15,19,14,136
1,1,16,1,1,24,42
0,1,13,1,0,11,25
1,1,13,5,1,23,42
1,1,19,5,0,37,61
1,1,19,1,0,31,51
1,1,11,5,0,19,35
1,1,18,3,0,32,53
1,1,17,1,1,38,57
1,2,17,3,0,20,40
1,2,18,4,1,19,42
1,2,19,3,0,24,46
1,2,16,3,0,15,34
1,2,12,5,1,21,39
1,2,17,3,0,36,56
1,2,19,4,1,21,45
1,2,13,5,0,20,38
1,2,14,0,1,37,52
1,2,14,5,0,39,58
1,2,13,1,0,19,33
1,2,18,5,1,25,49
1,2,15,1,1,15,32
1,2,19,2,0,30,51
1,2,18,2,1,27,48
1,2,13,1,0,38,52
1,2,19,2,0,32,53
1,2,116,0,1,9,126
1,2,60,12,8,15,95
1,2,82,15,0,19,116
0,2,67,23,7,3,100
1,2,59,27,10,18,114
0,2,66,6,9,5,86
1,2,120,10,3,16,149
3,2,121,22,30,0,173
3,2,130,27,39,5,201
3,2,139,31,44,3,217
3,2,129,14,43,5,191
3,2,131,28,43,5,207
3,2,119,39,24,1,183
3,2,142,25,34,5,206
3,2,123,22,22,3,170
1,2,106,19,38,4,167
3,2,115,39,20,2,176
2,2,111,17,32,1,161
1,2,144,26,50,3,223
3,2,126,31,48,2,207
2,2,73,22,21,29,145
1,2,28,7,25,18,78
1,2,31,10,40,9,90
2,2,51,14,33,14,112
1,2,22,7,39,23,91
1,2,46,5,11,21,83
2,2,72,22,21,27,142
1,2,70,5,5,29,109
1,2,28,9,9,24,70
1,2,44,5,11,23,83
1,2,27,6,13,30,76
1,2,20,6,6,23,55
1,2,29,7,3,28,67
1,2,20,6,5,27,58
1,2,65,9,15,22,111
1,2,36,5,6,20,67
1,2,99,21,21,6,147
3,2,101,21,34,18,174
3,2,98,29,34,12,173
1,2,113,20,7,13,153
2,2,75,24,27,7,133
2,2,71,21,38,11,141
3,2,119,13,32,7,171
3,2,114,11,39,13,177
1,2,99,26,8,11,144
1,2,39,12,21,9,81
3,2,114,26,16,20,176
3,2,120,32,39,9,200
3,2,143,24,35,6,208
3,2,121,28,21,5,175
3,2,134,23,28,10,195
2,2,103,13,37,10,163
3,2,122,12,48,10,192
3,2,145,39,23,6,213
3,2,105,13,48,10,176
3,2,144,13,40,10,207
2,2,103,18,40,5,166
3,2,120,15,34,8,177
1,2,56,19,16,13,104
1,2,56,5,17,14,92
1,2,108,15,13,5,141
2,2,58,23,14,34,129
2,2,58,13,11,33,115
1,2,76,24,14,15,129
2,2,69,8,13,28,118
0,2,54,9,12,10,85
1,2,89,7,10,10,116
1,2,110,18,18,10,156
1,2,86,12,17,18,133
1,2,82,7,16,9,114
1,2,102,5,19,11,137
1,2,16,5,0,21,42
1,2,11,3,1,39,54
0,2,18,5,0,11,34
1,2,12,0,1,32,45
1,2,15,4,1,39,59
1,2,15,4,0,26,45
1,2,13,1,0,30,44
1,2,12,3,0,28,43
1,3,17,2,1,20,40
1,3,14,5,1,33,53
0,3,16,3,1,11,31
1,3,18,2,1,13,34
1,3,12,2,1,17,32
1,3,17,4,1,15,37
1,3,18,1,1,25,45
0,3,20,1,1,10,32
1,3,15,1,0,21,37
1,3,11,3,1,34,49
1,3,19,0,1,13,33
1,3,10,3,0,14,27
1,3,17,5,1,17,40
0,3,16,1,0,11,28
1,3,11,0,1,33,45
1,3,10,5,0,39,54
1,3,12,3,0,32,47
1,3,106,16,10,10,142
0,3,69,18,0,12,99
1,3,103,26,6,12,147
1,3,99,25,6,6,136
0,3,85,9,4,11,109
1,3,109,0,3,8,120
1,3,106,27,1,6,140
3,3,133,28,31,3,195
3,3,108,39,34,5,186
2,3,101,12,48,1,162
3,3,145,11,29,1,186
3,3,112,33,29,3,177
2,3,111,18,32,4,165
3,3,133,39,44,2,218
3,3,115,34,37,5,191
3,3,135,35,38,3,211
3,3,142,40,28,3,213
2,3,124,11,27,2,164
3,3,122,29,31,5,187
1,3,101,19,23,5,148
1,3,72,5,15,20,112
1,3,100,13,23,9,145
1,3,32,10,33,8,83
2,3,42,25,37,12,116
2,3,81,25,40,20,166
1,3,56,18,9,23,106
2,3,84,9,31,17,141
1,3,36,9,8,28,81
1,3,32,5,11,27,75
1,3,26,7,15,27,75
1,3,34,5,5,22,66
1,3,66,9,6,30,111
1,3,69,10,4,24,107
1,3,44,7,9,20,80
1,3,58,10,5,27,100
1,3,27,6,14,30,77
1,3,19,21,25,15,80
1,3,39,15,30,8,92
1,3,109,21,10,12,152
1,3,93,10,9,15,127
1,3,73,16,12,11,112
3,3,111,18,29,16,174
1,3,37,20,10,19,86
1,3,74,23,13,20,130
1,3,32,28,35,6,101
1,3,34,23,19,17,93
1,3,59,25,9,20,113
3,3,145,12,24,8,189
3,3,118,17,28,8,171
3,3,145,20,47,8,220
3,3,140,25,46,10,221
3,3,120,35,43,7,205
3,3,126,24,31,7,188
3,3,106,22,43,5,176
3,3,137,40,28,9,214
3,3,108,40,25,6,179
3,3,135,15,50,6,206
3,3,121,21,49,8,199
1,3,59,6,20,6,91
2,3,59,13,18,27,117
1,3,103,7,15,15,140
2,3,56,14,14,31,115
1,3,106,23,12,9,150
1,3,109,5,16,17,147
1,3,110,5,20,11,146
2,3,86,15,15,23,139
2,3,91,18,19,26,154
2,3,99,19,15,28,161
1,3,93,14,20,17,144
2,3,89,25,13,23,150
2,3,107,15,12,24,158
1,3,16,5,0,14,35
1,3,14,5,1,20,40
1,3,18,3,0,24,45
1,3,12,3,0,40,55
1,3,14,4,1,27,46
1,3,18,5,1,15,39
1,3,10,4,1,23,38
1,3,10,5,0,14,29
1,4,14,3,0,28,45
1,4,10,2,0,38,50
1,4,19,0,0,32,51
1,4,20,3,0,19,42
1,4,18,3,0,14,35
0,4,11,2,0,12,25
1,4,17,1,1,13,32
1,4,10,0,1,36,47
1,4,17,0,0,32,49
1,4,20,5,1,22,48
1,4,12,3,0,17,32
1,4,13,0,0,31,44
1,4,11,1,1,35,48
1,4,18,2,0,19,39
1,4,15,0,1,24,40
1,4,14,3,0,25,42
1,4,12,0,1,16,29
1,4,85,24,5,5,119
0,4,71,22,5,2,100
1,4,108,4,5,3,120
1,4,63,29,5,15,112
1,4,62,12,3,18,95
1,4,118,15,3,11,147
1,4,90,21,2,14,127
3,4,141,30,31,1,203
3,4,126,31,33,2,192
3,4,112,26,30,4,172
2,4,112,12,38,4,166
3,4,144,14,33,4,195
3,4,127,13,36,1,177
3,4,146,10,44,5,205
3,4,146,22,26,4,198
2,4,101,10,48,5,164
1,4,104,19,24,4,151
3,4,150,20,43,0,213
3,4,110,35,45,2,192
3,4,139,15,28,2,184
2,4,99,17,32,7,155
1,4,22,15,7,19,63
1,4,11,12,21,24,68
1,4,47,20,18,16,101
2,4,54,1,35,26,116
1,4,26,16,13,16,71
3,4,99,18,39,19,175
1,4,31,9,11,28,79
1,4,24,8,13,23,68
1,4,21,7,9,20,57
1,4,60,10,5,25,100
1,4,29,9,12,21,71
1,4,37,7,14,28,86
1,4,53,7,11,22,93
1,4,35,5,15,25,80
1,4,53,6,10,28,97
1,4,114,18,17,8,157
1,4,95,28,22,9,154
2,4,62,23,38,19,142
1,4,70,28,12,12,122
0,4,35,20,10,8,73
1,4,60,23,10,20,113
1,4,40,22,25,9,96
0,4,53,21,6,11,91
2,4,99,16,38,7,160
2,4,86,21,31,18,156
2,4,79,28,35,13,155
3,4,146,25,33,8,212
3,4,116,24,36,6,182
3,4,107,14,44,5,170
3,4,115,20,27,9,171
3,4,113,23,43,6,185
2,4,102,20,31,5,158
3,4,138,27,21,7,193
3,4,146,13,38,9,206
3,4,139,33,41,7,220
3,4,130,24,48,9,211
3,4,135,31,34,8,208
1,4,106,22,16,20,164
3,4,109,23,14,26,172
1,4,108,24,19,10,161
1,4,50,16,16,11,93
1,4,102,22,17,10,151
2,4,72,25,10,27,134
1,4,91,13,18,13,135
0,4,67,19,11,8,105
0,4,61,14,10,5,90
2,4,107,13,14,28,162
2,4,91,5,12,34,142
2,4,106,18,13,27,164
1,4,107,14,10,18,149
1,4,17,4,1,20,42
1,4,11,4,1,30,46
1,4,11,4,0,23,38
1,4,16,3,1,36,56
1,4,11,0,1,30,42
1,4,15,4,1,25,45
1,4,16,5,0,27,48
1,4,14,3,1,15,33
